R 1024 768
NO ./textures/redbrick.xpm
SO ./textures/colorstone.xpm
WE ./textures/purplestone.xpm
EA ./textures/greystone.xpm

S ./textures/barrel.xpm
F 0,128,0
C 135,206,235

        1111111111111111111111111
        1000000000110000000000001
        1011000001110000020000001
        1001000000000000000000001
111111111011000001110000000000001
100000000011000001110111110011111
111101111111110111000000100001
111101111111110111000000100001
110000001101010111000000100001
100020000000000011000000100001
100000000000000000000100100001
11000001110101011100111100N001
11110111 1110101 1011110100001 
11111111 1111111 1111111111111  