R 800 600
NO ./path_to_the_north_texture
SO ./path_to_the_south_texture
WE ./path_to_the_west_texture
EA ./path_to_the_east_texture

S ./path_to_the_sprite_texture
F 0,128,0
C 135,206,235

        1111111111111111111111111
        1000000000110000000000001
        1011000001110000020000001
        1001000000000000000000001
111111111011000001110000000000001
100000000011000001110111110011111
111101111111110111000000100001
111101111111110111010100100001
110000001101010111000000100001
100020000000000011000000100001
100000000000000011010100100001
11000001110101011110111110N001
11110111 1110101 1011110100001 
11111111 1111111 1111111111111  