R 1080 768
NO ./textures/redbrick.xpm
SO ./textures/colorstone.xpm
WE ./textures/purplestone.xpm
EA ./textures/greystone.xpm

S ./textures/barrel.xpm
F 0,128,0
C 135,206,235

        1111111111111111111111111
        1000000000110000000000001
        1011000001110000000002001
        1001002000000000000000001
111111111011000001110000000000001
100000000011000001110111100011111
111001111111110111110000000001
111001111111110111110000000001
110000001101010111000000000201
100000000000000011000000000001
10000200000000000000010000N001
110000011101010111001111000001
11110111 1110101 1011110100001
11111111 1111111 1111111111111